,below_i2,above_gr,asp_below,trial,scale,plddt
0,11,17,6,Abl1 M290L,256:512 First Replicate,88.071875
1,6,17,11,Abl1 M290L,256:512 Second Replicate,86.631875
2,11,20,9,Abl1 M290L,256:512 Third Replicate,87.07625000000002
3,5,38,33,Abl1 L301I,256:512 First Replicate,87.10499999999999
4,9,38,29,Abl1 L301I,256:512 Second Replicate,87.13474999999998
5,5,36,31,Abl1 L301I,256:512 Third Replicate,85.73052083333333
6,9,47,38,Abl1 F382V,256:512 First Replicate,85.86723214285713
7,8,49,41,Abl1 F382V,256:512 Second Replicate,85.98382812499999
8,10,49,39,Abl1 F382V,256:512 Third Replicate,86.07305555555556
9,7,39,32,Abl1 F382Y,256:512 First Replicate,86.15674999999999
10,5,37,32,Abl1 F382Y,256:512 Second Replicate,86.2209659090909
11,6,35,29,Abl1 F382Y,256:512 Third Replicate,85.56958333333334
12,7,37,30,Abl1 M290L + L301I,256:512 First Replicate,85.71
13,7,35,28,Abl1 M290L + L301I,256:512 Second Replicate,85.82133928571427
14,2,43,41,Abl1 M290L + L301I,256:512 Third Replicate,85.905875
15,15,28,13,Abl1,256:512 First Replicate,86.0119140625
16,16,25,9,Abl1,256:512 Second Replicate,85.93136029411764
17,14,27,13,Abl1,256:512 Third Replicate,86.02184027777777
18,12,27,15,Abl1 E255V,256:512 First Replicate,86.10042763157894
19,6,19,13,Abl1 E255V,256:512 Second Replicate,86.18412499999998
20,5,16,11,Abl1 E255V,256:512 Third Replicate,86.2571130952381
21,14,25,11,Abl1 T315I,256:512 First Replicate,86.31335227272727
22,10,19,9,Abl1 T315I,256:512 Second Replicate,86.37222826086956
23,11,22,11,Abl1 T315I,256:512 Third Replicate,86.04494791666666
24,8,23,15,Abl1 F382L,256:512 First Replicate,86.092525
25,8,23,15,Abl1 F382L,256:512 Second Replicate,85.82096153846153
26,8,22,14,Abl1 F382L,256:512 Third Replicate,85.56863425925926
27,12,25,13,Abl1 E255V + T315I,256:512 First Replicate,85.62200892857142
28,8,24,16,Abl1 E255V + T315I,256:512 Second Replicate,85.66206896551724
29,8,24,16,Abl1 E255V + T315I,256:512 Third Replicate,85.70570833333332
